33
95 55 32 94 13 33 84 16 26 92 75 94 31 34 68 55 78 100 41 14 50 60 59 16 80 39 45 79 87 64 18 12 32
97 18 61 25 74 97 99 21 100 66 49 52 78 24 78 83 32 84 65 47 51 46 30 61 44 12 32 24 49 15 90 66 66
34 13 27 54 24 15 30 38 60 10 71 92 38 36 58 85 42 72 69 61 36 31 59 19 51 42 26 97 30 95 91 63 92
76 85 100 61 59 95 56 75 90 72 64 58 56 15 29 27 31 68 30 70 37 97 91 65 58 99 63 77 63 44 26 30 17
87 89 56 26 97 66 74 99 50 63 65 78 55 61 30 19 28 11 43 55 81 63 88 61 61 17 45 18 32 32 72 50 45
56 53 43 55 59 49 22 86 26 38 34 100 24 74 55 39 62 66 22 63 49 18 90 93 22 37 38 19 53 71 73 57 75
46 83 58 12 77 27 63 64 80 84 78 71 88 12 24 69 46 84 60 29 99 95 18 36 86 35 29 12 50 51 71 100 28
49 27 85 68 34 19 21 42 34 79 91 97 19 96 47 71 35 90 14 73 49 30 83 16 17 43 99 64 59 69 89 25 98
38 26 73 97 69 51 78 65 62 39 29 14 16 26 97 33 70 62 27 14 91 39 65 92 69 34 86 75 28 13 11 83 17
17 99 65 90 33 92 83 36 21 57 27 17 100 30 22 53 73 20 20 28 65 90 44 33 18 85 80 46 75 91 91 94 89
94 83 86 55 29 29 11 59 92 74 66 84 93 31 75 19 40 86 11 50 10 40 36 90 99 64 16 67 35 76 64 26 39
91 11 82 50 20 74 70 27 62 98 65 86 99 56 45 67 30 69 71 49 36 55 41 44 90 24 14 89 31 34 21 80 33
87 41 46 75 28 37 66 85 59 62 35 67 69 99 48 54 32 72 73 91 65 91 32 88 95 28 24 88 96 58 98 72 13
85 90 12 78 94 92 32 54 73 88 90 37 55 37 17 22 54 18 11 42 50 31 35 23 22 53 65 81 20 95 99 39 19
49 55 46 28 14 97 19 74 25 65 27 27 86 56 56 80 66 63 97 80 92 55 73 98 45 89 58 91 70 88 82 44 94
60 65 56 85 24 98 40 39 49 37 38 92 41 77 88 51 36 21 14 42 33 97 20 22 32 18 48 54 28 94 96 93 23
16 44 69 42 78 89 48 61 35 34 58 91 29 88 35 75 14 36 38 28 85 79 10 82 68 22 57 69 40 27 35 49 12
95 67 47 58 13 11 17 68 48 82 45 86 82 26 28 69 91 97 21 32 83 81 27 65 19 96 42 56 22 67 99 27 26
42 40 93 78 89 87 33 98 50 43 58 27 79 38 30 41 14 100 74 68 99 26 56 41 100 50 68 76 60 42 42 88 98
30 18 17 61 40 50 49 17 39 24 99 52 26 31 54 78 45 65 32 54 22 76 38 69 80 96 37 76 51 83 47 39 66
32 45 40 35 48 25 20 21 43 37 83 76 35 33 75 61 18 100 93 93 87 46 68 41 55 48 73 76 27 29 10 62 80
100 67 67 98 98 43 28 41 32 72 51 89 45 68 18 87 58 39 86 32 76 71 89 50 63 74 82 99 68 35 65 61 57
53 17 92 38 76 28 99 61 99 96 96 77 68 51 84 81 43 90 91 38 47 75 42 12 85 75 49 42 91 13 99 83 33
79 46 90 89 61 46 81 35 43 19 97 35 99 93 93 30 55 24 44 47 94 59 75 60 57 56 34 21 50 80 67 98 92
61 43 75 59 81 68 64 11 26 49 31 12 63 92 54 21 26 37 87 43 70 82 55 63 36 94 41 83 18 34 36 12 52
81 95 25 74 15 96 94 62 68 12 70 71 81 46 13 29 79 84 72 63 53 52 33 72 79 87 95 20 45 93 52 41 12
11 62 22 100 66 30 94 58 48 52 52 10 41 44 54 50 29 21 72 77 99 52 64 14 21 74 83 73 55 89 76 48 27
16 42 70 68 88 66 18 96 74 18 48 18 73 96 29 14 28 36 83 23 27 55 14 84 23 62 46 71 47 78 19 25 74
61 60 58 74 88 49 33 84 65 45 49 33 27 75 93 10 27 33 27 66 50 92 12 30 25 46 73 88 35 74 79 25 97
26 16 18 97 87 42 64 80 98 67 72 40 10 23 67 33 84 21 32 39 100 62 70 65 77 66 47 50 56 87 38 47 23
53 97 74 82 46 42 20 99 25 99 45 92 80 26 63 98 39 82 90 43 21 99 25 92 78 56 32 77 35 39 50 13 60
97 16 36 46 92 67 15 11 33 24 31 92 58 86 88 66 71 60 41 89 92 79 77 26 43 49 62 29 87 33 60 11 50
13 98 23 17 90 73 20 40 72 56 50 11 41 93 44 20 33 11 88 90 21 45 76 62 94 64 72 83 85 94 94 22 72
